057 057 057 057 057 057 057 057 057 057 057 057 057 057 057 057 057 057 057 057 057 057 057 057 057 057 057 057 057 057 057 057 057 057 057 057 057 057 057 057 057 057 057 057 057 057 057 057 057 057 057 057 057 057 057 057 057 057 057 057 057 057 057 057
057 057 057 057 057 057 057 057 057 057 057 057 057 057 057 057 057 057 057 057 057 057 057 057 057 057 057 057 057 057 057 057 057 057 057 057 057 057 057 057 057 057 057 057 057 057 057 057 057 057 057 057 057 057 057 057 057 057 057 057 057 057 057 057
057 057 057 057 057 057 057 057 057 057 057 057 057 057 057 057 057 057 057 057 057 057 057 057 057 057 057 057 057 057 057 057 057 057 057 057 057 057 057 057 057 057 057 057 057 057 057 057 057 057 057 057 057 057 057 057 057 057 057 057 057 057 057 057
057 057 057 057 057 057 057 057 057 057 057 057 057 057 057 057 057 057 057 057 057 057 057 057 057 057 057 057 057 057 057 057 057 057 057 057 057 057 057 057 057 057 057 057 057 057 057 057 057 057 057 057 057 057 057 057 057 057 057 057 057 057 057 057
057 057 057 057 057 057 057 057 057 057 057 057 057 057 057 057 057 057 057 057 057 057 057 057 057 057 057 057 057 057 057 057 057 057 057 057 057 057 057 057 057 057 057 057 057 057 057 057 057 057 057 057 057 057 057 057 057 057 057 057 057 057 057 057
057 057 057 057 057 057 057 057 057 057 057 057 057 057 057 057 057 057 057 057 057 057 057 057 057 057 057 057 057 057 057 057 057 057 057 057 057 057 057 057 057 057 057 057 057 057 057 057 057 057 057 057 057 057 057 057 057 057 057 057 057 057 057 057
057 057 057 057 057 057 057 057 057 057 057 057 057 057 057 057 057 057 057 057 057 057 057 057 057 057 057 057 057 057 057 057 057 057 057 057 057 057 057 057 057 057 057 057 057 057 057 057 057 057 057 057 057 057 057 057 057 057 057 057 057 057 057 057
057 057 057 057 057 057 057 057 057 057 057 057 057 057 057 057 057 057 057 057 057 057 057 057 057 057 057 057 057 057 057 057 057 057 057 057 057 057 057 057 057 057 057 057 057 057 057 057 057 057 057 057 057 057 057 057 057 057 057 057 057 057 057 057
057 057 057 057 057 057 057 057 057 057 057 057 057 057 057 057 057 057 057 057 057 057 057 057 057 057 057 057 057 057 057 057 057 057 057 057 057 057 057 057 057 057 057 057 057 057 057 057 057 057 057 057 057 057 057 057 057 057 057 057 057 057 057 057
057 057 057 107 108 109 057 057 057 057 057 057 057 057 057 057 057 057 057 057 057 057 057 057 057 057 057 057 057 057 057 057 057 057 057 057 057 057 057 057 057 057 057 057 057 057 057 057 057 057 057 057 057 057 057 057 057 057 057 057 057 057 057 057
057 057 057 110 111 112 057 057 057 057 057 057 057 057 057 057 057 057 057 057 057 057 057 057 057 057 057 057 057 057 057 057 057 057 057 057 057 057 057 057 057 057 057 057 057 057 057 057 057 057 057 057 057 057 057 057 057 057 057 057 057 057 057 057
057 057 057 113 114 115 057 057 057 057 057 057 057 057 057 057 057 057 057 057 057 057 057 057 057 057 057 057 057 057 057 057 057 057 057 057 057 057 057 057 057 057 057 057 057 057 057 057 057 057 057 057 057 057 057 057 057 057 057 057 057 057 057 057
057 057 057 116 117 118 057 057 057 057 057 057 057 057 057 057 057 057 057 057 057 057 057 057 057 057 057 057 057 057 057 057 057 057 057 057 057 057 057 057 057 057 057 057 057 057 057 057 057 057 057 057 057 057 057 057 057 057 057 057 057 057 057 057
057 057 057 057 057 057 057 107 108 109 057 057 057 057 057 057 057 057 057 057 057 057 057 057 057 057 057 057 057 057 057 057 057 057 057 057 057 057 057 057 057 057 057 057 057 057 057 057 057 057 057 057 057 057 057 057 057 057 057 057 057 057 057 057
057 057 057 057 057 057 057 110 111 112 057 057 057 057 057 057 057 057 057 057 057 057 057 057 057 057 057 057 057 057 057 057 057 057 057 057 057 057 057 057 057 057 057 057 057 057 057 057 057 057 057 057 057 057 057 057 057 057 057 057 057 057 057 057
057 057 057 057 057 057 057 113 114 115 057 057 057 057 057 057 057 057 057 057 107 108 109 057 057 057 057 057 057 057 057 057 057 057 057 057 057 057 057 057 057 057 057 057 057 057 057 057 057 057 057 057 057 057 057 057 057 057 057 057 057 057 057 057
057 057 057 057 057 057 057 116 117 118 057 057 057 057 057 057 057 057 057 057 110 111 112 057 057 057 057 057 152 153 057 119 120 121 057 057 057 057 057 057 057 057 057 057 057 057 057 057 057 057 057 057 057 057 057 057 057 057 057 057 057 057 057 057
057 057 057 057 057 057 107 108 109 057 057 057 057 057 057 057 057 057 057 057 113 114 115 057 057 057 057 057 154 155 057 122 123 124 057 057 057 057 057 057 057 057 057 057 057 057 057 057 057 057 057 057 057 057 057 057 057 057 057 057 057 057 057 057
057 057 057 057 057 057 110 111 112 057 057 057 057 057 057 057 057 057 057 057 116 117 118 057 057 057 057 057 057 057 057 125 126 127 057 057 057 057 057 057 057 057 057 143 057 057 057 057 057 057 057 057 057 057 057 057 057 057 057 057 057 057 057 057
057 057 131 132 133 057 113 114 115 057 057 057 057 057 057 057 057 057 057 148 149 057 057 057 057 057 057 057 057 057 057 128 129 130 057 057 057 057 057 057 057 057 057 057 057 057 057 057 057 057 057 057 057 057 057 057 057 057 057 057 057 057 057 057
057 057 134 135 136 057 116 117 118 057 057 107 108 109 057 057 057 057 057 150 151 057 057 057 057 057 057 057 057 057 057 057 057 057 057 057 057 057 057 057 057 057 057 057 057 057 057 057 057 057 057 057 152 153 057 057 057 057 057 057 057 057 057 057
057 057 137 138 139 057 057 057 057 057 057 110 111 112 057 057 057 057 057 057 057 057 057 057 057 057 057 057 057 057 057 057 057 057 057 057 057 057 057 057 057 057 057 057 057 057 057 057 057 057 057 057 154 155 057 057 057 057 057 057 057 057 057 057
057 057 140 141 142 057 057 057 057 057 057 113 114 115 057 057 057 057 057 057 057 057 057 057 057 057 057 057 057 057 057 057 057 057 057 057 057 057 057 057 057 057 057 057 057 057 057 057 057 057 057 057 057 057 057 057 057 057 057 057 131 132 133 057
057 057 057 057 057 057 057 057 131 132 133 116 117 118 057 057 057 057 057 057 057 057 057 057 057 057 057 057 057 057 057 057 057 057 057 107 108 109 057 057 057 057 057 057 057 057 057 057 131 132 133 107 108 109 131 132 133 057 057 057 134 135 136 057
057 057 057 057 057 057 057 057 134 135 136 057 057 057 057 057 057 057 057 057 057 057 057 057 057 057 057 057 057 057 057 057 057 057 057 110 111 112 057 057 057 057 057 057 057 131 132 133 134 135 136 110 111 112 134 135 136 119 120 121 137 138 139 057
057 057 057 057 057 057 057 057 137 138 139 057 057 057 057 057 057 057 057 057 057 057 057 057 057 057 057 057 057 057 057 057 057 057 057 113 114 115 057 057 057 107 108 109 057 134 135 136 137 138 139 113 114 115 137 138 139 122 123 124 140 141 142 057
057 057 057 057 057 057 057 057 140 141 142 057 057 057 057 057 057 057 057 057 057 057 057 131 132 133 057 057 057 057 057 057 057 057 057 116 117 118 057 057 057 110 111 112 057 137 138 139 140 141 142 116 117 118 140 141 142 125 126 127 057 131 132 133
057 057 057 057 057 057 057 119 120 121 057 057 057 057 131 132 133 057 057 057 057 057 057 134 135 136 057 057 057 057 057 057 057 057 057 057 057 057 057 057 057 113 114 115 057 140 141 142 057 057 057 057 057 057 057 057 057 128 129 130 057 134 135 136
057 057 057 057 131 132 133 122 123 124 057 057 057 057 134 135 136 057 057 057 057 057 057 137 138 139 057 057 057 143 057 057 057 057 057 057 057 057 057 057 057 116 117 118 131 132 133 057 057 057 057 057 057 057 057 057 057 057 107 108 109 137 138 139
057 057 057 057 134 135 136 125 126 127 057 057 057 057 137 138 139 057 057 057 057 057 057 140 141 142 057 057 057 057 057 057 057 057 057 057 057 057 057 057 107 108 109 057 134 135 136 057 057 057 057 057 057 057 057 057 057 057 110 111 112 140 141 142
057 057 057 057 137 138 139 057 129 057 057 057 057 057 140 141 142 057 057 057 057 057 057 057 057 057 057 057 057 057 057 057 057 057 057 057 057 057 057 057 110 111 112 057 137 138 139 057 057 057 057 057 057 057 057 057 057 057 113 114 115 057 057 057
057 057 057 057 140 141 142 057 057 057 057 057 057 057 057 057 057 057 057 057 057 057 057 057 057 057 057 057 057 057 057 057 057 057 057 057 057 057 057 057 113 114 115 057 140 141 142 057 057 057 057 057 057 057 057 057 057 057 116 117 118 057 057 057
057 057 057 057 057 057 057 057 057 057 057 057 057 057 057 057 057 057 057 057 057 057 057 057 057 057 057 057 057 057 057 057 057 057 057 057 057 057 057 057 116 117 118 057 057 131 132 133 057 057 057 057 057 057 057 057 057 131 132 133 057 057 057 057
057 057 057 057 057 057 057 057 057 057 057 057 057 057 057 057 057 057 057 057 057 057 057 057 057 057 057 057 057 057 057 057 057 057 057 057 057 057 057 057 057 119 120 121 057 134 135 136 107 108 109 119 120 121 107 108 109 134 135 136 057 057 057 057
103 103 103 103 103 103 103 103 103 103 103 103 104 057 057 057 057 057 057 057 057 057 057 057 057 057 057 057 057 057 057 057 057 057 057 057 143 057 057 057 057 122 123 124 057 137 138 139 110 111 112 122 123 124 110 111 112 137 138 139 057 057 057 057
057 057 057 057 057 057 057 057 057 057 057 057 105 057 057 057 057 057 057 057 057 057 057 057 057 057 057 057 057 057 057 057 057 057 057 057 057 057 057 057 057 125 126 127 057 140 141 142 113 114 115 125 126 127 113 114 115 140 141 142 057 057 057 057
057 057 057 057 057 057 057 057 057 057 057 057 105 057 057 057 057 057 057 057 057 057 057 057 057 057 057 057 148 149 057 057 057 057 057 057 057 057 057 057 057 128 129 130 057 057 057 057 116 117 118 128 129 130 116 117 118 057 057 057 057 057 057 057
057 057 057 057 057 057 057 057 057 057 057 057 105 057 057 057 057 057 057 057 057 057 057 057 057 057 057 057 150 151 057 057 057 057 057 057 057 057 057 057 057 057 057 057 057 057 057 057 057 057 057 057 057 057 057 057 057 057 057 057 057 057 057 057
057 057 057 057 057 057 057 057 057 057 057 057 105 057 057 152 153 057 057 057 057 057 057 057 057 057 057 057 057 057 057 057 057 057 057 057 057 057 057 057 057 057 057 057 057 057 057 057 057 057 057 057 057 057 057 057 057 057 057 057 057 057 057 057
057 057 057 057 057 057 057 057 057 057 057 057 105 057 057 154 155 057 057 057 057 057 057 057 057 057 057 057 057 057 057 057 057 057 057 057 057 057 144 145 057 057 057 057 057 057 057 057 057 057 057 057 057 057 057 057 057 057 057 057 057 057 057 057
057 057 057 057 057 057 057 057 057 057 057 057 105 057 057 057 057 057 057 057 057 057 057 057 057 057 057 057 057 057 057 057 057 057 057 057 057 057 057 057 057 057 057 057 057 057 057 057 057 057 057 057 057 057 057 057 057 057 057 057 057 057 057 057
057 057 057 057 057 057 057 057 057 057 057 057 106 103 103 104 057 057 057 057 057 057 057 057 057 057 057 057 057 057 057 057 057 057 057 057 057 057 057 057 107 108 109 057 057 057 057 057 057 057 057 057 057 057 057 057 057 057 057 057 057 057 057 057
057 057 057 057 057 057 057 057 057 057 057 057 057 057 057 105 057 057 057 057 057 107 108 109 057 057 057 057 057 057 131 132 133 057 057 057 057 057 057 057 110 111 112 057 057 057 057 057 057 057 057 057 057 057 057 057 057 057 057 057 057 057 057 057
057 057 057 057 057 057 057 057 057 057 057 057 057 057 057 105 057 057 057 057 057 110 111 112 057 057 057 057 057 057 134 135 136 057 057 057 057 057 057 057 113 114 115 057 057 057 057 057 057 057 057 057 057 057 057 057 057 057 057 057 057 057 057 057
057 057 057 057 057 057 057 057 057 057 057 057 057 057 057 106 103 103 103 103 104 113 114 115 057 057 057 057 057 057 137 138 139 057 057 057 057 057 057 057 116 117 118 057 057 057 057 057 057 057 057 057 057 057 057 057 057 057 057 057 057 057 057 057
057 057 057 057 057 057 057 057 057 057 057 057 057 057 057 057 057 057 057 057 105 116 117 118 057 057 057 057 057 057 140 141 142 119 120 121 057 057 057 057 057 057 057 057 131 132 133 057 057 057 057 057 057 057 057 057 057 057 057 057 057 057 057 057
057 057 057 057 057 057 057 057 057 057 057 057 057 057 057 057 057 057 057 057 105 057 057 057 057 057 057 057 057 057 057 057 057 122 123 124 057 057 057 057 057 057 057 057 134 135 136 057 057 057 057 057 057 057 057 057 057 057 057 057 057 057 057 057
057 057 057 057 057 057 057 057 057 057 057 057 057 057 057 057 057 057 057 057 105 057 057 057 057 057 057 057 057 057 057 057 057 125 126 127 057 057 057 057 057 057 057 057 137 138 139 057 057 057 057 057 057 057 057 057 057 057 057 057 057 057 057 057
057 057 057 057 057 057 057 057 057 057 057 057 057 057 057 057 057 057 057 057 105 057 057 057 057 057 057 057 057 057 057 057 057 128 129 130 057 057 057 057 057 057 057 057 140 141 142 057 057 057 057 057 057 057 057 057 057 057 057 057 057 057 057 057
057 057 057 057 057 057 057 057 057 057 057 057 057 057 057 057 057 057 057 057 105 057 057 057 057 057 057 057 057 057 057 057 057 057 057 057 057 057 057 057 057 057 057 057 057 057 057 057 057 057 057 057 057 057 057 057 057 057 057 057 057 057 057 057