094 094 094 094 094 094 094 017 093 093 093 093 093 093 093 093 093 093 093 093 093 093 093 093 093 093 093 093 093 093 093 093 093 093 093 093 054 093 093 093 093 093 093 093 092 093 093 093 093 093 093 093 093 093 093 093 093 093 093 093 093 093 093 093
094 094 094 094 094 094 094 017 093 093 093 093 093 093 093 093 093 093 093 093 092 093 093 093 093 093 093 093 093 093 093 093 093 093 093 093 093 093 093 093 093 093 093 093 093 093 093 093 093 093 093 091 093 093 093 093 093 093 060 093 093 093 093 093
094 023 029 029 021 094 094 017 093 093 060 093 093 093 093 093 093 093 093 093 093 093 093 060 093 093 091 093 093 093 093 093 054 093 093 093 091 093 093 093 093 093 093 093 093 091 093 093 054 093 093 093 093 060 093 093 093 093 093 093 093 093 093 093
094 017 036 036 013 094 094 017 093 093 093 093 093 093 093 093 091 093 093 093 093 093 093 093 093 093 093 093 093 093 093 093 093 093 093 093 093 093 093 092 093 093 093 093 093 093 093 093 092 093 093 093 093 093 093 093 093 093 092 093 093 093 093 093
094 017 043 043 020 094 094 017 093 093 093 093 093 093 093 093 093 093 093 093 093 093 093 093 093 093 093 093 093 093 093 092 093 093 093 093 093 093 093 093 093 093 093 093 093 093 093 093 093 093 093 093 093 093 093 093 093 093 093 093 093 093 093 093
094 017 050 050 027 028 029 030 093 093 093 093 093 054 093 093 093 093 093 093 093 093 093 093 093 093 093 093 093 093 093 093 093 093 001 002 002 002 002 002 002 002 002 002 002 002 002 002 002 002 002 002 002 002 002 002 002 002 002 002 002 002 003 093
094 017 057 048 034 035 036 037 093 093 093 093 093 093 093 093 093 093 093 092 093 093 093 093 054 093 093 093 093 093 093 093 093 093 013 023 021 022 023 021 022 023 021 022 023 021 022 023 021 022 023 021 022 023 021 022 023 021 022 023 021 022 017 093
094 017 093 040 041 042 043 044 093 093 093 093 093 093 093 093 093 093 093 093 093 093 093 093 093 093 093 093 091 093 093 093 093 093 013 009 007 008 009 007 008 009 007 008 009 007 008 009 007 008 009 007 008 009 007 008 009 007 008 009 007 008 017 093
094 017 093 055 048 049 050 051 046 093 093 093 093 093 093 093 093 093 093 093 093 054 093 093 093 093 093 093 093 093 093 093 093 093 013 016 014 015 016 014 015 016 014 015 016 014 015 016 014 015 016 014 015 016 014 015 016 014 015 016 014 015 017 093
094 017 093 093 055 056 057 058 059 093 093 093 060 092 093 093 093 093 093 093 093 093 093 093 093 093 093 093 093 093 054 093 093 093 013 021 015 009 021 015 009 021 015 009 021 015 009 021 015 009 021 015 009 021 015 009 021 015 009 021 015 009 017 093
029 030 093 093 093 093 093 093 093 093 093 093 093 093 093 093 093 093 093 093 093 093 093 093 093 093 093 093 093 093 093 093 093 093 013 023 021 022 023 021 022 023 021 022 023 021 022 023 021 022 023 021 022 023 021 022 023 021 022 023 021 022 017 093
036 037 093 093 093 093 093 093 093 093 093 093 093 093 093 093 001 002 002 002 002 002 002 002 002 002 002 002 002 002 002 002 002 002 030 009 007 008 009 007 008 009 007 008 009 007 008 009 007 008 009 007 008 009 007 008 009 007 008 009 007 008 017 093
043 044 093 093 060 093 093 093 093 093 054 093 093 093 093 093 013 016 014 015 016 014 015 016 014 015 016 014 015 016 014 015 016 014 015 016 014 015 016 014 015 016 014 015 016 014 015 016 014 015 016 014 015 016 014 015 016 014 015 016 014 015 017 093
050 051 046 093 093 093 093 093 054 093 093 093 093 093 093 093 013 021 015 009 021 015 009 021 015 009 021 015 009 021 015 009 021 015 009 021 015 009 021 015 009 021 015 009 021 015 009 021 015 009 021 015 009 021 015 009 021 015 009 021 015 009 017 093
057 058 053 093 093 093 093 093 091 093 093 093 093 093 093 093 013 023 021 022 023 021 022 023 021 022 023 021 022 023 021 022 023 021 022 023 021 022 023 021 022 023 021 022 023 021 022 023 021 022 023 021 022 023 021 022 023 021 022 023 021 022 017 093
060 093 093 093 093 093 093 093 093 093 093 093 093 093 093 093 013 009 007 008 009 007 008 009 007 008 009 007 008 009 007 008 009 007 008 009 007 008 009 007 008 009 007 008 009 007 008 009 007 008 009 007 008 009 007 008 009 007 008 009 007 008 017 093
093 093 091 093 093 093 093 093 093 093 093 093 092 093 093 093 013 016 014 015 016 014 015 016 014 015 016 014 015 016 014 015 016 014 015 016 014 015 016 014 015 016 014 015 016 014 015 016 014 015 016 014 015 016 014 015 016 014 015 001 029 029 030 093
093 093 093 093 093 093 093 093 093 093 093 093 093 093 093 093 013 021 015 009 021 015 009 021 015 009 021 015 009 021 015 009 021 015 009 021 015 009 021 015 009 021 015 009 021 015 009 021 015 009 021 015 009 021 015 009 021 015 009 017 031 036 037 046
002 002 002 002 002 002 002 002 002 002 002 002 002 002 002 002 030 023 021 022 023 021 022 023 021 022 023 021 022 023 021 022 023 021 022 023 021 022 023 021 022 023 021 022 023 021 022 023 021 022 023 021 022 023 021 022 023 021 022 017 052 057 058 059
007 008 009 007 008 009 007 008 009 007 008 009 007 008 009 007 008 009 007 008 009 007 008 009 007 008 009 007 008 009 007 008 009 007 008 009 007 008 009 007 008 009 007 008 009 007 008 009 007 008 009 007 008 009 007 008 009 007 008 017 059 093 093 093
014 015 016 014 015 016 014 015 016 014 015 016 014 015 016 014 015 016 014 015 016 014 015 016 014 015 016 014 015 016 014 015 016 014 015 016 014 015 016 014 015 016 014 015 016 014 015 016 014 015 016 014 015 016 014 015 016 014 015 017 093 093 093 093
021 022 023 021 022 023 021 022 023 021 022 023 021 022 023 021 022 023 021 022 023 021 022 023 021 022 023 021 022 023 021 022 023 021 022 023 021 022 023 021 022 023 021 022 023 021 022 023 021 022 023 021 022 023 021 022 023 021 022 017 093 093 093 093
015 009 021 015 009 021 015 009 021 015 009 021 015 009 021 015 009 021 015 009 021 015 009 021 015 009 021 015 009 021 015 009 021 015 009 021 015 009 021 015 009 021 015 009 021 015 009 021 015 009 021 015 009 021 015 009 021 015 009 017 093 093 092 093
029 029 029 029 029 029 029 029 029 029 029 029 029 029 029 029 029 029 029 029 029 029 029 029 029 029 029 029 029 029 029 029 029 029 029 029 029 029 029 029 029 029 010 008 009 007 008 009 007 008 009 007 008 009 007 008 009 007 008 017 093 093 093 093
036 036 036 036 036 036 036 036 036 036 036 036 036 036 036 036 036 036 036 036 036 036 036 036 036 036 036 036 036 036 036 036 036 036 036 036 036 036 036 036 036 027 013 015 016 014 015 016 014 015 016 014 015 016 014 015 016 014 015 017 093 093 093 093
057 057 057 057 057 057 057 057 057 057 057 057 057 057 057 057 057 057 057 057 057 057 057 057 057 057 057 057 057 057 057 057 057 057 057 057 057 057 057 057 057 048 013 022 023 021 022 023 021 022 023 021 022 023 021 022 023 001 029 030 093 093 093 093
093 093 093 093 093 093 093 093 093 093 093 093 093 093 093 093 093 093 093 093 093 093 093 093 093 093 093 093 093 093 093 093 093 093 093 093 093 093 093 093 093 055 013 009 021 015 009 021 015 009 021 015 009 021 015 009 021 017 031 037 046 093 093 093
093 093 093 093 091 093 093 093 093 093 093 054 093 093 093 093 093 093 093 093 093 093 093 092 093 093 093 093 093 093 093 093 093 093 093 093 093 093 093 060 093 093 013 008 009 007 008 009 007 008 009 007 008 009 007 008 009 017 052 058 059 093 093 093
093 093 093 093 093 093 093 093 092 093 093 093 093 093 054 093 093 093 093 093 093 093 093 093 093 093 054 093 093 093 060 093 093 093 093 093 093 093 093 093 093 093 020 029 029 029 029 029 029 029 029 029 029 029 029 010 014 017 093 093 093 093 093 093
093 092 093 093 093 060 093 093 093 093 093 093 093 093 093 093 093 091 093 093 093 060 093 093 093 093 093 092 093 093 093 093 093 093 091 093 093 093 093 093 093 040 035 036 036 036 036 036 036 036 036 036 036 036 027 013 022 017 093 093 093 092 093 093
093 093 093 093 093 093 093 093 093 093 093 093 093 093 093 093 093 093 093 093 092 093 093 093 093 093 093 093 093 093 093 093 093 093 093 060 093 093 054 093 093 055 057 057 057 057 057 057 057 057 057 057 057 057 048 013 023 017 093 093 093 093 093 093
093 001 002 002 002 002 002 002 002 002 002 002 002 010 093 093 093 093 093 093 093 093 091 093 093 093 093 093 093 093 093 093 093 093 093 093 093 093 093 093 093 093 093 093 093 093 093 093 093 093 093 093 093 093 093 020 029 030 093 093 093 093 093 093
093 013 021 015 009 021 015 009 021 015 009 021 015 017 093 093 093 093 093 093 093 093 093 093 093 093 093 093 093 093 091 093 093 093 093 093 093 093 093 093 093 093 060 093 093 093 093 093 093 093 093 060 093 093 040 035 099 037 046 093 093 093 093 093
093 013 023 021 022 023 021 022 023 021 022 023 021 017 093 093 093 093 093 093 093 093 093 093 093 092 093 093 093 093 093 093 093 093 093 093 092 093 093 060 093 093 093 093 093 060 093 093 093 093 093 093 093 093 055 056 091 058 059 093 093 093 093 093
093 013 016 014 015 016 014 015 016 014 015 016 014 017 093 093 093 054 093 093 093 054 093 093 093 093 093 093 060 093 093 093 093 093 093 093 093 093 093 093 093 093 093 093 093 093 093 093 093 093 093 093 093 093 093 093 091 093 093 093 093 093 093 093
093 013 009 007 008 009 007 008 009 007 008 009 007 017 093 054 093 093 093 093 093 093 093 093 093 093 093 093 093 093 093 093 092 093 093 093 093 093 093 093 093 093 093 093 093 093 093 093 093 092 093 093 093 093 093 093 091 093 093 093 093 093 093 093
093 013 021 015 009 021 015 009 021 015 009 021 015 017 093 093 093 093 093 093 093 093 091 093 093 093 093 093 093 093 093 093 093 093 093 093 093 093 093 093 093 093 091 093 093 093 093 060 093 093 093 093 093 093 093 093 091 093 093 093 001 002 003 093
093 013 023 021 022 023 021 022 023 021 022 023 021 017 093 093 093 093 093 093 093 093 093 093 093 093 093 093 093 093 093 093 093 093 093 093 093 093 093 093 093 093 093 093 093 093 093 093 093 060 093 093 093 093 093 093 091 091 091 091 013 016 017 093
093 013 016 014 015 016 014 015 016 014 015 016 014 020 002 002 002 002 002 002 002 002 002 002 002 002 002 010 093 093 093 093 093 093 093 093 093 093 093 093 092 093 093 093 093 093 093 093 093 093 093 093 093 093 093 093 093 093 093 093 013 009 017 093
093 013 009 007 008 009 007 008 009 007 008 009 007 008 009 007 008 009 007 008 009 007 008 009 007 008 009 017 093 054 093 093 092 093 093 093 093 091 093 093 093 093 093 093 093 093 093 091 093 093 054 093 093 093 092 093 060 093 093 093 013 007 017 093
093 013 021 015 009 021 015 009 021 015 009 021 015 009 021 015 009 021 015 009 021 015 009 021 015 009 021 017 093 093 093 093 093 093 093 093 093 093 093 093 093 054 093 093 093 093 093 093 093 093 093 093 093 093 093 093 093 093 093 093 013 021 017 093
093 013 023 021 022 023 021 022 023 021 022 023 021 022 023 021 022 023 021 022 023 021 022 023 021 022 023 017 093 093 093 060 093 093 093 093 093 093 093 093 093 093 093 093 093 093 093 093 093 093 093 093 093 093 054 093 093 093 093 093 013 023 017 093
093 013 016 014 015 016 014 015 016 014 015 016 014 015 016 014 015 016 014 015 016 014 015 016 014 015 016 020 002 002 002 002 002 002 002 002 002 002 002 002 002 002 002 002 002 002 002 002 002 002 002 002 002 002 002 002 002 002 002 002 030 014 017 093
093 013 009 007 008 009 007 008 009 007 008 009 007 008 009 007 008 009 007 008 009 007 008 009 007 008 009 009 007 008 009 007 008 009 007 008 009 007 008 009 007 008 009 007 008 009 007 008 009 007 008 009 009 007 008 009 007 008 009 007 008 009 017 093
093 013 021 015 009 021 015 009 021 015 009 021 015 009 021 015 009 021 015 009 021 015 009 021 015 009 021 021 015 009 021 015 009 021 015 009 021 015 009 021 015 009 021 015 009 021 015 009 021 015 009 021 021 015 009 021 015 009 021 015 009 021 017 093
093 013 023 021 022 023 021 022 023 021 022 023 021 022 023 021 022 023 021 022 023 021 022 023 021 022 023 023 021 022 023 021 022 023 021 022 023 021 022 023 021 022 023 021 022 023 021 022 023 021 022 023 023 021 022 023 021 022 023 021 022 023 017 093
093 013 016 014 015 016 014 015 016 014 015 016 014 015 016 014 015 016 014 015 016 014 015 016 014 015 016 016 014 015 016 014 015 016 014 015 016 014 015 016 014 015 016 014 015 016 014 015 016 014 015 016 016 014 015 016 014 015 016 014 015 016 017 093
093 020 029 029 029 029 029 029 029 029 029 029 029 029 029 029 029 029 029 029 029 029 029 029 029 029 029 029 029 029 029 029 029 029 029 029 029 029 029 029 029 029 029 029 029 029 029 029 029 029 029 029 029 029 029 029 029 029 029 029 029 029 030 093
040 035 036 036 036 036 036 036 036 036 036 036 036 036 036 036 036 036 036 036 036 036 036 036 036 036 036 036 036 036 036 036 036 036 036 036 036 036 036 036 036 036 036 036 036 036 036 036 036 036 036 036 036 036 036 036 036 036 036 036 036 036 037 046
055 057 057 057 057 057 057 057 057 057 057 057 057 057 057 057 057 057 057 057 057 057 057 057 057 057 057 057 057 057 057 057 057 057 057 057 057 057 057 057 057 057 057 057 057 057 057 057 057 057 057 057 057 057 057 057 057 057 057 057 057 057 057 059
