030 031 026 026 070 071 026 026 140 026 026 026 026 026 026 026 026 026 026 026 026 026 026 026 026 026 026 026 026 026 026 026 026 026 026 026 026 026 026 026 026 026 026 026 026 026 026 026 026 026 026 026 026 026 026 026 026 026 026 026 026 026 036 037
053 054 056 057 093 094 056 057 140 057 056 057 056 057 056 057 056 057 056 057 056 057 056 057 056 057 056 057 056 057 056 057 056 057 056 057 056 057 056 057 056 057 056 057 056 057 056 057 056 057 056 057 056 057 056 057 056 057 056 057 056 057 059 060
076 077 079 080 093 094 079 080 079 080 079 080 079 080 079 080 079 080 079 080 079 080 079 080 079 080 079 080 079 080 079 080 079 080 079 080 079 080 079 080 079 080 079 080 079 080 079 080 079 080 079 080 079 080 079 080 079 080 079 080 079 080 082 083
099 100 102 103 093 094 102 103 102 103 102 103 102 103 102 103 102 103 102 103 102 103 102 103 102 103 102 103 102 103 102 103 102 103 102 103 102 103 102 103 102 103 102 103 102 103 102 103 102 103 102 103 102 103 102 103 102 103 102 103 102 103 105 106
122 123 125 126 093 094 125 126 125 126 125 126 125 126 125 126 125 126 125 126 125 126 125 126 125 126 125 126 125 126 125 126 125 126 125 126 125 126 125 126 125 126 125 126 125 126 125 126 125 126 125 126 125 126 125 126 125 126 125 126 125 126 128 129
145 146 148 149 116 117 148 149 148 149 148 149 148 149 148 149 148 149 148 149 148 149 148 149 148 149 148 149 148 149 148 149 148 149 148 149 148 149 148 149 148 149 148 149 148 149 148 149 148 149 148 149 148 149 148 149 148 149 148 149 148 149 151 152
026 026 026 026 026 026 026 026 026 026 026 026 140 026 026 026 026 026 026 026 026 026 026 026 026 026 026 026 026 026 026 026 026 026 026 026 026 026 026 026 026 026 143 026 026 026 026 026 026 026 050 051 026 026 026 026 026 026 142 026 026 026 026 026
026 026 026 026 140 026 026 026 141 026 026 026 026 026 026 026 026 026 026 026 026 141 026 026 026 026 026 141 026 026 026 026 141 026 026 143 026 026 026 026 026 026 026 026 026 026 026 026 026 026 026 026 026 026 026 026 026 026 026 026 026 026 026 026
026 026 024 025 026 026 026 026 026 026 026 143 026 026 140 026 141 026 026 026 143 026 026 026 026 026 026 026 026 026 142 026 026 026 026 026 026 026 026 140 026 026 141 026 026 026 026 026 026 026 141 026 026 026 026 026 026 026 026 026 026 026 026 026
026 026 047 048 026 026 026 026 026 026 026 026 026 026 026 026 026 026 026 026 026 026 143 026 026 141 026 026 143 026 026 026 026 026 026 026 026 026 026 026 026 026 026 026 026 026 026 026 026 026 026 026 026 142 026 026 026 026 026 026 140 026 026 026
026 026 026 026 026 026 026 026 140 026 026 026 026 026 026 026 026 143 026 026 026 026 026 026 026 026 026 026 026 026 026 143 026 026 026 026 026 026 026 026 142 026 026 026 026 026 026 026 026 026 026 026 027 028 026 026 142 026 026 026 026 026 026 026
026 026 026 142 026 026 027 028 026 026 026 026 026 026 026 026 026 026 026 026 140 026 026 142 026 026 026 026 026 026 026 026 026 026 026 026 026 026 026 026 026 026 026 026 026 142 026 026 026 142 026 026 050 051 026 026 026 026 026 026 026 026 026 026
026 026 026 026 026 026 026 050 051 026 026 026 143 026 026 026 026 026 026 026 026 026 026 026 026 026 026 026 027 028 026 026 026 026 026 026 026 026 026 026 026 026 026 026 026 026 026 026 026 026 026 026 026 026 026 026 026 026 026 026 026 026 026 026
030 031 026 026 026 026 026 026 026 026 026 026 026 026 026 026 026 026 026 026 026 026 026 026 026 026 026 026 050 051 026 026 026 026 026 026 026 026 026 026 026 026 026 026 026 026 026 026 026 026 026 026 026 026 070 071 026 026 026 026 026 026 036 037
053 054 056 057 056 057 056 057 056 057 056 057 056 057 056 057 056 057 056 057 056 057 056 057 056 057 056 057 056 057 056 057 056 057 056 057 056 057 056 057 056 057 056 057 056 057 056 057 056 057 056 057 056 057 093 094 056 057 056 057 056 057 059 060
076 077 079 080 079 080 079 080 079 080 079 080 079 080 079 080 079 080 079 080 079 080 079 080 079 080 079 080 079 080 079 080 079 080 079 080 079 080 079 080 079 080 079 080 079 080 079 080 079 080 079 080 079 080 093 094 079 080 079 080 079 080 082 083
099 100 102 103 102 103 102 103 102 103 102 103 102 103 102 103 102 103 102 103 102 103 102 103 102 103 102 103 102 103 102 103 102 103 102 103 102 103 102 103 102 103 102 103 102 103 102 103 102 103 102 103 102 103 093 094 102 103 102 103 102 103 105 106
122 123 125 126 125 126 125 126 125 126 125 126 125 126 125 126 125 126 125 126 125 126 125 126 125 126 125 126 125 126 125 126 125 126 125 126 125 126 125 126 125 126 125 126 125 126 125 126 125 126 125 126 125 126 093 094 125 126 125 126 125 126 128 129
145 146 148 149 148 149 148 149 148 149 148 149 148 149 148 149 148 149 148 149 148 149 148 149 148 149 148 149 148 149 148 149 148 149 148 149 148 149 148 149 148 149 148 149 148 149 148 149 148 149 148 149 148 149 093 094 148 149 148 149 148 149 151 152
026 026 026 026 026 026 026 026 026 026 026 026 026 026 026 026 026 026 026 026 026 026 026 026 026 026 026 141 026 026 026 026 026 026 026 026 026 026 026 026 026 026 026 026 026 026 026 026 026 026 026 026 026 026 026 026 026 026 026 026 026 026 026 026
026 026 142 026 026 026 026 026 026 143 026 026 026 026 026 026 026 142 026 026 026 143 026 026 026 026 026 026 026 026 026 140 026 026 026 026 026 026 026 026 026 026 026 026 140 026 026 026 026 026 026 026 024 025 026 026 026 026 026 026 026 026 026 026
026 026 026 026 026 026 026 142 026 026 026 026 026 026 026 026 026 026 026 026 026 026 026 026 027 028 026 026 026 026 026 026 026 026 026 026 141 026 026 026 026 026 026 026 026 026 026 026 026 026 026 026 047 048 026 026 026 026 026 026 026 026 026 026
026 026 024 025 026 026 026 026 026 026 026 026 026 026 026 026 026 026 026 026 026 026 026 026 050 051 026 026 141 026 026 026 143 026 026 026 026 026 143 026 026 026 026 026 142 026 026 026 026 026 026 026 026 026 026 026 026 026 026 026 026 026 026 026
026 026 047 048 026 026 026 026 026 026 026 026 141 026 026 026 026 143 141 026 026 026 143 026 026 026 026 026 026 140 026 026 026 026 026 026 027 028 026 026 026 026 026 026 026 026 026 026 026 027 028 026 026 026 026 026 026 140 026 026 026 026 026 026
026 026 026 026 141 026 026 026 026 142 026 026 026 026 026 026 026 026 026 026 026 026 026 026 026 026 026 026 026 026 026 026 026 143 026 026 050 051 026 026 026 026 026 026 026 140 026 026 026 050 051 026 026 026 141 026 026 026 026 026 026 026 026 026
026 026 143 026 026 026 026 026 026 026 026 026 026 143 026 026 026 026 026 026 026 026 026 141 026 026 026 026 026 026 026 142 026 026 026 026 026 026 026 026 026 026 026 026 026 026 026 026 026 026 026 026 026 026 026 026 026 026 026 026 026 026 026 026
030 031 026 026 026 026 070 071 026 026 026 026 026 026 026 026 026 026 026 026 026 026 026 026 026 026 026 026 026 026 026 026 026 026 026 026 026 026 026 026 026 026 026 026 026 026 026 026 026 026 026 026 026 026 026 026 026 026 026 026 026 026 036 037
053 054 056 057 056 057 093 094 056 057 056 057 056 057 056 057 056 057 056 057 056 057 056 057 056 057 056 057 056 057 056 057 056 057 056 057 056 057 056 057 056 057 056 057 056 057 056 057 056 057 056 057 056 057 056 057 056 057 056 057 056 057 059 060
076 077 079 080 079 080 093 094 079 080 079 080 079 080 079 080 079 080 079 080 079 080 079 080 079 080 079 080 079 080 079 080 079 080 079 080 079 080 079 080 079 080 079 080 079 080 079 080 079 080 079 080 079 080 079 080 079 080 079 080 079 080 082 083
099 100 102 103 102 103 093 094 102 103 102 103 102 103 102 103 102 103 102 103 102 103 102 103 102 103 102 103 102 103 102 103 102 103 102 103 102 103 102 103 102 103 102 103 102 103 102 103 102 103 102 103 102 103 102 103 102 103 102 103 102 103 105 106
122 123 125 126 125 126 093 094 125 126 125 126 125 126 125 126 125 126 125 126 125 126 125 126 125 126 125 126 125 126 125 126 125 126 125 126 125 126 125 126 125 126 125 126 125 126 125 126 125 126 125 126 125 126 125 126 125 126 125 126 125 126 128 129
145 146 148 149 148 149 116 117 148 149 148 149 148 149 148 149 148 149 148 149 148 149 148 149 148 149 148 149 148 149 148 149 148 149 148 149 148 149 148 149 148 149 148 149 148 149 148 149 148 149 148 149 148 149 148 149 148 149 148 149 148 149 151 152
026 026 026 026 026 026 026 026 026 026 026 026 026 026 026 026 026 026 026 026 026 026 026 026 026 026 026 141 026 026 026 026 026 026 026 026 026 026 026 026 026 026 026 026 026 026 026 026 026 026 026 026 026 026 026 026 026 026 026 026 026 026 026 026
026 026 142 026 026 026 026 026 026 143 026 026 026 026 026 026 026 142 026 026 026 143 026 026 026 026 026 026 026 026 026 140 026 026 026 026 026 026 026 026 026 026 026 026 140 026 026 026 026 026 026 026 024 025 026 026 026 026 026 026 026 026 026 026
026 026 026 026 026 026 026 142 026 026 026 026 026 026 026 026 026 026 026 026 026 026 026 026 027 028 026 026 026 026 026 026 026 026 026 026 141 026 026 026 026 026 026 026 026 026 026 026 026 026 026 026 047 048 026 026 026 026 026 026 026 026 026 026
026 026 024 025 026 026 026 026 026 026 026 026 026 026 026 026 026 026 026 026 026 026 026 026 050 051 026 026 141 026 026 026 143 026 026 026 026 026 143 026 026 026 026 026 142 026 026 026 026 026 026 026 026 026 026 026 026 026 026 026 026 026 026 026
026 026 047 048 026 026 026 026 026 026 026 026 141 026 026 026 026 143 141 026 026 026 143 026 026 026 026 026 026 140 026 026 026 026 026 026 027 028 026 026 026 026 026 026 026 026 026 026 026 027 028 026 026 026 026 026 026 140 026 026 026 026 026 026
026 026 026 026 141 026 026 026 026 142 026 026 026 026 026 026 026 026 026 026 026 026 026 026 026 026 026 026 026 026 026 026 026 143 026 026 050 051 026 026 026 026 026 026 026 140 026 026 026 050 051 026 026 026 141 026 026 026 026 026 026 026 026 026
026 026 143 026 026 026 026 026 026 026 026 026 026 143 026 026 026 026 026 026 026 026 026 141 026 026 026 026 026 026 026 142 026 026 026 026 026 026 026 026 026 026 026 026 026 026 026 026 026 026 026 026 026 026 026 026 026 026 026 026 026 026 026 026
026 026 026 026 026 143 026 026 026 026 026 026 026 026 026 026 026 026 143 026 141 026 026 026 143 026 026 026 026 026 026 026 026 026 141 026 026 026 026 026 026 143 026 026 026 026 026 026 026 026 026 026 026 026 026 026 026 026 026 140 026 026 026 026
026 026 026 142 026 026 026 141 026 026 026 026 026 026 026 141 026 026 026 026 026 026 026 026 026 026 026 026 141 026 026 026 026 026 026 026 026 026 142 026 026 026 026 026 026 026 026 026 026 142 026 026 141 026 026 026 026 026 026 026 026 026 026 026
026 026 026 026 026 026 140 026 026 026 140 026 026 026 026 026 026 140 026 026 026 026 026 026 026 026 143 026 026 026 027 028 026 026 026 026 140 026 026 026 026 026 026 026 026 026 026 026 026 026 141 026 026 026 026 026 026 026 026 026 026 026 026 026
026 026 140 026 026 026 026 026 026 026 026 026 026 026 026 026 143 026 026 026 026 026 143 026 026 026 140 026 026 026 050 051 026 026 026 026 026 026 026 026 026 026 026 026 140 026 026 141 026 026 027 028 026 142 026 026 026 026 026 026 026 026 026 026
026 026 026 026 026 026 026 026 026 026 026 026 140 026 026 026 026 026 026 026 026 026 026 026 026 026 026 026 026 026 026 026 026 026 026 026 026 026 026 026 026 026 143 026 026 026 026 026 026 026 050 051 026 026 026 026 026 026 142 026 026 026 026 026
026 026 026 026 140 026 026 026 141 026 026 026 026 026 026 026 026 026 026 026 026 141 026 026 026 026 026 141 026 026 026 026 141 026 026 143 026 026 026 026 026 026 026 026 026 026 026 026 026 026 026 026 026 026 026 026 026 026 026 026 026 026 026 026
026 026 024 025 026 026 026 026 026 026 026 143 026 026 140 026 141 026 026 026 143 026 026 026 026 026 026 026 026 026 142 026 026 026 026 026 026 026 026 140 026 026 141 026 026 026 026 026 026 026 141 026 026 026 026 026 026 026 026 026 026 026 026 026
026 026 047 048 026 026 026 026 026 026 026 026 026 026 026 026 026 026 026 026 026 026 143 026 026 141 026 026 143 026 026 026 026 026 026 026 026 026 026 026 026 026 026 026 026 026 026 026 026 026 026 026 026 142 026 026 026 026 026 026 140 026 026 026
026 026 026 026 026 026 026 026 140 026 026 026 026 026 026 026 026 026 026 026 026 026 026 026 026 026 026 026 026 026 026 143 026 026 026 026 026 026 026 026 142 026 026 026 026 026 026 026 026 026 026 026 027 028 026 026 142 026 026 026 026 026 026 026
026 026 026 142 026 026 026 026 026 026 026 026 026 026 026 026 026 026 026 026 140 026 026 026 026 026 026 026 026 026 026 026 026 026 026 026 026 026 026 026 026 026 026 026 026 142 026 026 026 142 026 026 050 051 026 026 026 026 026 026 026 026 026 026
026 026 026 026 026 026 026 026 026 026 026 026 026 026 026 026 026 026 026 026 026 026 026 026 026 026 026 026 026 026 026 026 026 026 026 026 026 026 026 026 026 026 026 026 026 026 026 026 026 026 026 026 026 026 026 026 026 026 026 026 026 026 026 026