085 085 085 085 085 085 085 087 080 080 080 080 086 085 085 085 085 085 085 085 085 085 085 085 085 085 085 085 085 085 085 085 085 085 085 085 085 085 085 085 085 085 085 085 085 085 085 085 085 085 085 085 085 085 085 085 085 085 085 085 085 085 085 085
085 085 085 085 085 085 085 087 080 080 080 080 086 085 085 085 085 085 085 085 085 085 085 085 085 085 085 085 085 085 085 085 085 085 085 085 085 085 085 085 085 085 085 085 085 085 085 085 085 085 085 085 085 085 085 085 085 085 085 085 085 085 085 085
085 010 085 085 085 085 085 087 080 080 080 080 086 085 085 085 085 085 085 085 085 085 085 085 085 085 085 085 085 085 085 085 085 085 085 085 085 085 085 085 085 085 085 085 085 085 085 085 085 085 085 085 085 085 085 085 085 085 085 085 085 085 085 085
085 021 085 009 006 085 009 087 080 080 080 080 086 085 085 085 085 085 085 085 085 085 085 085 085 085 085 085 085 085 085 085 085 085 085 085 085 085 085 085 085 085 085 085 085 085 085 085 085 085 085 085 085 085 085 085 085 085 085 085 085 085 085 085
085 006 006 085 010 085 085 087 080 080 080 080 086 085 085 085 085 085 085 085 085 085 085 085 085 085 085 085 085 085 085 085 085 085 085 085 085 085 085 085 085 085 085 085 085 085 085 085 085 085 085 085 085 085 085 085 085 085 085 085 085 085 085 085
085 085 006 085 006 085 085 087 080 080 080 080 086 085 085 085 085 085 085 085 085 085 085 085 085 085 085 085 085 085 085 085 085 085 085 085 085 085 085 085 085 085 085 085 085 085 085 085 085 085 085 085 085 085 085 085 085 085 085 085 085 085 085 085
085 085 085 021 006 085 085 087 080 080 080 080 074 079 079 077 085 085 085 085 085 085 085 085 085 085 085 085 085 085 085 085 085 085 085 085 085 085 085 085 085 085 085 085 085 085 085 085 085 085 085 085 085 085 085 085 085 085 085 085 085 085 085 085
085 085 006 006 085 085 085 087 080 080 080 080 080 080 080 074 078 079 079 078 078 077 085 085 085 085 085 085 085 085 085 085 085 085 085 085 085 085 085 085 085 085 085 085 085 085 085 085 085 085 085 085 085 085 085 085 085 085 085 085 085 085 085 085
085 010 085 005 085 085 085 087 080 080 080 080 080 080 080 080 080 080 080 080 080 074 078 079 077 085 085 085 085 085 085 085 085 085 085 085 085 085 085 085 085 085 085 085 085 085 085 085 085 085 085 085 085 085 085 085 085 085 085 085 085 085 085 085
085 085 085 085 085 085 085 087 080 080 080 080 080 080 080 080 080 080 080 080 080 080 080 080 074 079 079 079 078 077 085 085 085 085 085 085 085 085 085 085 085 085 085 085 085 085 085 085 085 085 085 085 085 085 085 085 085 085 085 085 085 085 085 085
085 006 009 085 085 085 005 087 080 080 080 080 080 080 080 080 080 080 080 080 080 080 080 080 080 080 080 080 080 086 085 085 085 085 085 085 085 085 085 085 085 085 085 085 085 085 085 085 085 085 085 085 085 085 085 085 085 085 085 085 085 085 085 085
085 085 006 085 085 085 085 089 088 088 088 088 073 080 080 080 080 080 080 080 080 080 080 080 080 080 080 080 080 074 078 078 077 085 085 085 085 085 085 085 085 085 085 085 085 085 085 085 091 092 093 085 085 085 085 085 085 085 085 085 085 085 085 085
085 006 005 006 009 085 021 085 006 085 085 005 089 088 088 088 088 088 088 088 073 080 080 080 080 080 080 080 080 080 080 080 086 085 085 085 085 085 085 085 085 085 085 085 076 078 079 078 094 095 096 079 079 078 077 085 085 085 085 085 085 085 085 085
085 085 085 085 005 010 085 085 085 009 085 085 085 085 085 085 085 085 005 085 089 088 088 073 080 080 080 080 080 080 080 080 074 079 079 079 078 078 078 079 079 079 079 078 075 080 080 080 097 098 099 080 080 080 074 078 079 079 079 077 085 085 085 085
085 006 006 085 005 085 085 085 085 006 006 085 085 085 005 085 085 021 085 085 085 085 085 089 088 088 088 073 080 080 080 080 080 080 080 080 080 080 080 080 080 080 080 080 080 080 080 080 097 098 099 080 080 080 080 080 080 080 080 086 085 085 085 085
085 009 006 005 085 085 085 085 085 085 085 085 085 006 006 085 085 085 085 085 010 085 085 085 005 085 085 087 080 080 080 080 080 080 080 080 080 080 080 080 080 080 080 080 080 080 080 080 097 098 099 080 080 080 080 080 080 080 080 074 077 085 085 085
085 010 085 085 085 085 085 085 085 085 085 010 085 009 085 006 085 085 009 085 085 085 085 085 085 085 021 089 088 088 088 088 088 088 088 088 088 088 088 088 088 088 088 088 088 088 088 088 100 101 102 088 088 088 088 088 088 073 080 080 086 085 085 085
085 006 085 085 085 085 085 085 085 085 005 085 085 006 085 085 085 085 085 021 006 085 085 085 006 085 009 085 085 085 085 085 006 085 085 021 085 085 085 009 085 085 085 085 021 009 085 085 023 024 006 085 085 085 085 085 085 087 080 080 074 077 085 085
085 085 085 021 006 085 085 009 006 085 085 006 085 006 006 085 085 006 085 085 085 010 085 006 010 006 085 085 085 085 006 085 009 085 085 085 009 085 085 085 085 006 006 085 023 024 024 024 084 017 082 085 085 085 085 085 085 089 073 080 080 074 078 079
085 085 006 006 085 085 006 021 006 085 085 010 006 085 085 085 006 009 085 085 085 085 085 085 085 085 085 085 085 006 085 085 085 006 085 009 085 085 006 023 024 024 024 024 084 020 020 019 020 020 020 034 085 021 006 085 085 085 087 080 080 080 080 080
085 085 085 085 085 005 006 006 085 085 085 085 085 085 085 085 085 021 085 085 085 085 006 085 085 085 006 085 085 085 006 005 023 024 024 024 024 024 024 084 020 020 020 018 020 020 020 020 020 020 081 085 085 085 009 085 085 085 089 073 080 080 080 080
085 085 085 085 085 085 010 085 085 085 009 085 085 085 085 085 085 085 006 085 023 024 024 024 024 024 026 085 085 085 023 024 084 020 020 020 019 020 020 020 020 020 020 020 020 020 020 020 020 081 006 085 085 085 085 085 010 085 085 089 073 080 080 080
085 085 010 085 085 085 085 085 085 085 085 085 085 085 085 085 085 005 023 024 084 020 019 020 020 020 082 024 024 024 084 020 020 017 020 020 020 020 020 017 020 020 020 020 020 020 081 036 036 006 006 085 005 085 085 085 085 085 085 085 089 088 088 088
085 085 085 009 085 085 085 085 005 085 006 085 085 085 085 085 005 023 084 020 020 020 020 020 020 020 020 020 018 020 020 020 020 020 020 020 081 083 020 020 020 081 036 036 036 036 006 085 085 021 085 085 085 085 085 085 085 085 085 009 085 085 085 085
085 085 085 085 085 085 085 085 085 085 085 009 006 085 085 006 085 031 020 017 020 020 020 020 020 017 020 020 020 020 020 020 020 081 036 036 085 085 036 036 036 006 006 085 085 085 085 085 085 085 085 085 085 085 085 085 085 085 021 085 085 085 085 085
085 005 085 085 085 006 085 005 006 085 085 085 085 085 006 085 085 031 020 020 018 081 036 036 036 036 036 083 020 020 020 020 081 006 006 085 085 085 085 085 085 085 085 085 085 085 085 085 085 085 005 085 010 085 085 085 085 085 085 085 085 085 085 085
085 085 005 085 021 006 085 085 085 010 006 085 085 085 006 085 085 031 020 020 081 006 085 085 085 006 085 006 036 036 036 036 006 085 085 085 085 085 085 085 006 085 085 085 005 085 085 009 010 085 085 085 085 085 085 085 085 085 085 085 085 085 009 085
085 085 085 006 006 009 006 085 085 005 085 085 085 085 085 085 006 031 020 020 034 006 006 085 085 085 085 021 006 085 085 085 085 085 085 085 085 021 085 085 005 085 085 085 085 006 085 085 085 085 009 006 021 085 085 085 005 085 085 085 085 005 085 085
085 085 085 006 085 010 006 085 006 085 085 085 085 085 085 005 085 031 020 020 082 026 006 085 085 006 085 085 085 085 085 085 085 085 009 085 085 009 085 085 085 085 010 085 085 085 021 085 006 006 023 024 025 026 085 009 085 085 085 085 085 085 085 085
085 085 085 085 085 005 085 085 085 085 085 085 085 010 006 085 006 031 020 020 020 034 085 085 085 006 085 085 006 009 006 085 085 006 085 085 085 085 085 085 085 085 085 085 085 085 085 085 085 021 027 020 019 030 010 085 085 085 085 009 085 085 085 085
085 006 005 085 005 006 085 085 006 085 085 021 085 006 085 085 006 031 020 018 020 034 085 085 085 085 006 085 006 021 010 006 006 009 085 085 085 085 085 005 085 085 085 009 085 085 085 085 085 085 031 020 020 034 021 085 085 085 085 085 085 085 085 085
085 009 021 006 085 006 085 006 009 010 006 085 085 085 085 085 023 084 020 020 020 034 006 085 006 006 085 006 085 006 006 085 006 085 006 085 085 085 085 085 085 085 085 085 085 085 085 085 005 085 035 036 037 038 010 085 085 085 085 085 085 085 085 085
085 006 010 085 006 085 085 009 009 009 009 085 085 085 085 085 031 020 020 020 018 034 006 085 006 010 085 006 085 085 085 085 085 085 006 010 085 006 085 085 085 085 085 085 085 085 085 085 085 085 006 021 009 010 085 085 005 085 085 085 085 085 085 085
085 006 085 085 085 085 021 006 085 085 085 085 085 005 085 085 031 017 020 020 081 038 085 085 009 085 085 085 085 085 085 085 085 085 006 085 085 006 009 006 085 005 085 006 085 085 085 085 085 006 006 085 085 006 006 085 085 006 021 085 085 085 085 085
085 085 085 085 085 085 085 085 085 085 085 085 085 085 006 085 031 020 020 020 082 026 085 085 006 006 009 021 085 005 085 085 085 006 085 085 085 085 006 085 085 085 085 010 085 085 085 085 085 085 085 085 085 085 085 085 006 009 085 085 085 085 085 085
078 078 079 078 079 078 078 079 078 079 079 079 077 085 085 006 031 020 020 019 020 034 006 085 085 085 085 085 085 085 009 085 085 085 085 085 085 085 085 085 085 085 085 085 085 085 085 006 085 085 085 009 006 085 085 085 085 085 085 085 085 085 085 085
080 080 080 080 080 080 080 080 080 080 080 080 086 085 085 006 035 083 020 020 020 034 006 085 085 085 085 085 085 085 085 021 085 085 005 085 085 085 085 085 085 085 085 006 021 006 085 006 009 085 085 085 085 085 085 085 085 085 085 085 085 085 085 085
080 080 080 080 080 080 080 080 080 080 080 080 086 085 085 085 006 031 020 020 020 034 005 006 085 009 085 085 085 085 085 085 085 085 085 085 085 009 085 085 085 085 085 085 006 085 009 085 006 085 085 085 085 085 085 085 085 085 006 085 085 085 085 085
080 080 080 080 080 080 080 080 080 080 080 080 086 085 085 085 085 031 020 018 020 082 024 024 024 024 026 023 024 024 024 024 024 026 085 085 085 085 085 006 085 085 085 085 085 085 085 085 085 085 085 085 085 085 085 085 085 085 085 085 005 085 085 085
080 080 080 080 080 080 080 080 080 080 080 080 086 085 085 085 085 031 020 020 020 020 020 020 020 020 082 084 018 020 020 020 020 082 026 009 085 085 006 085 085 085 085 085 085 085 085 085 085 006 085 006 010 006 085 006 010 085 085 085 085 085 009 085
080 080 080 080 080 080 080 080 080 080 080 080 086 085 010 085 085 035 083 020 020 020 020 017 020 020 020 020 020 020 020 020 020 020 082 024 026 085 085 085 085 085 085 085 006 085 085 085 006 085 006 085 085 085 009 006 085 085 085 085 085 085 085 085
080 080 080 080 080 080 080 080 080 080 080 080 086 085 085 085 085 085 035 036 083 020 019 020 020 020 020 020 020 017 020 020 020 020 019 020 082 026 085 006 085 085 085 085 085 005 085 085 085 006 009 085 085 005 085 005 006 085 085 085 085 085 085 085
080 080 080 080 080 080 080 080 080 080 080 080 074 079 079 077 085 010 085 085 035 036 036 036 036 036 036 036 036 036 036 083 020 020 020 020 020 082 026 085 006 085 085 085 085 085 085 006 021 085 085 009 006 085 021 009 085 085 085 085 085 085 085 085
080 080 080 080 080 080 080 080 080 080 080 080 080 080 080 086 085 085 085 085 085 085 085 085 006 006 085 021 085 006 006 035 036 083 020 020 020 020 082 026 006 085 085 085 006 085 085 006 006 085 021 085 085 085 085 085 085 085 085 085 085 005 085 085
080 080 080 080 080 080 080 080 080 080 080 080 080 080 080 086 085 085 085 085 085 085 085 006 085 085 085 085 085 005 006 009 006 035 083 017 020 020 020 034 085 085 021 006 085 085 085 085 085 085 085 085 010 006 085 021 085 085 085 085 085 085 085 085
080 080 080 080 080 080 080 080 080 080 080 080 080 080 080 074 079 079 079 079 077 085 085 085 085 085 085 006 085 085 085 006 085 085 031 020 020 020 020 034 006 085 085 006 085 085 085 009 085 085 021 085 006 085 085 085 085 085 085 085 006 085 085 085
080 080 080 080 080 080 080 080 080 080 080 080 080 080 080 080 080 080 080 080 086 085 085 085 006 009 005 085 006 085 085 085 006 085 035 083 020 018 020 034 006 085 085 010 085 085 085 085 085 009 085 085 085 006 085 085 085 085 085 085 021 006 005 085
080 080 080 080 080 080 080 080 080 080 080 080 080 080 080 080 080 080 080 080 086 085 006 010 085 006 085 085 085 010 085 085 085 085 006 031 020 020 020 034 085 006 085 085 006 021 085 085 085 085 085 085 009 085 085 085 085 085 085 085 085 006 085 085
080 080 080 080 080 080 080 080 080 080 080 080 080 080 080 080 080 080 080 080 086 006 085 085 085 006 085 085 085 085 006 085 009 085 085 031 020 020 020 034 085 085 085 085 085 085 006 085 085 085 085 006 006 085 085 085 085 085 085 085 085 085 009 085
080 080 080 080 080 080 080 080 080 080 080 080 080 080 080 080 080 080 080 080 086 021 085 085 085 085 085 085 085 085 085 085 085 085 085 084 020 020 020 082 085 085 085 085 085 085 085 085 085 085 085 085 085 085 085 085 085 085 085 085 085 085 085 085